[
  {
    "type": "mapgen",
    "method": "json",
    "om_terrain": [
      [ "arcology_z0_1_1", "arcology_z0_2_1", "arcology_z0_3_1", "arcology_z0_4_1" ],
      [ "arcology_z0_1_2", "arcology_z0_2_2", "arcology_z0_3_2", "arcology_z0_4_2" ],
      [ "arcology_z0_1_3", "arcology_z0_2_3", "arcology_z0_3_3", "arcology_z0_4_3" ],
      [ "arcology_z0_1_4", "arcology_z0_2_4", "arcology_z0_3_4", "arcology_z0_4_4" ]
    ],
    "weight": 1,
    "object": {
      "fill_ter": "t_thconc_floor",
      "rows": [
        "''''''''''''''''''''''''''''''''''''''''''''''''''''''''''''''''''''''''''''''''''''''''''''''''",
        "''#''#''#''#''#''#''#''#''#''#''#''#''#''#''#''''''#''#''#''#''#''#''#''#''#''#''#''#''#''#''#''",
        "'############################################MMMMMM############################################'",
        "''#< M''''                                   ''''''                                       #<<#''",
        "''#< M''''                                   ''''''                                       #  #''",
        "'#####  '' #  #  #  #  #  #  #  #  #  #  #   ''''''   #  #  #  #  #  #  #  #  #  #  #  #  #MM##'",
        "''#     '' #  #  #  #  #  #  #  #  #  #  #   ''''''   #  #  #  #  #  #  #  #  #  #  #  #   ''#''",
        "''#     ''                           ''''''''''''''''''''''                                ''#''",
        "'##  ## '''''''''''''''''''''''''''''''''''''''''''''''''''''''''''''''''''''''''''''''''''''##'",
        "''#     '''''''''''''''''''''''''''''''''''''''''''''''''''''''''''''''''''''''''''''''''''''#''",
        "''#     ''                           ''~~~~~''''''''~~~~~''                           ''     #''",
        "'##  ## '' ##    ##    ##    ##    ##''~~~~~''''''''~~~~~''##    ##    ##    ##    ## '' ##  ##'",
        "''#     '' ##    ##    ##    ##    ##''~~T~~''''''''~~T~~''##    ##    ##    ##    ## ''     #''",
        "''#     ''                           ''~~~~~''''''''~~~~~''                           ''     #''",
        "'##  ## ''                           ''~~~~~''''''''~~~~~''                           '' ##  ##'",
        "''#     ''                           ''~~T~~''''''''~~T~~''                           ''     #''",
        "''#     ''                           ''~~~~~''''''''~~~~~''                           ''     #''",
        "'##  ## '' ##    ##    ##    ##    ##''~~~~~''''''''~~~~~''##    ##    ##    ##    ## '' ##  ##'",
        "''#     '' ##    ##    ##    ##    ##''~~T~~''''''''~~T~~''##    ##    ##    ##    ## ''     #''",
        "''#     ''                           ''~~~~~''''''''~~~~~''                           ''     #''",
        "'##  ## ''                           ''~~~~~''''''''~~~~~''                           '' ##  ##'",
        "''#     ''                           ''~~T~~''''''''~~T~~''                           ''     #''",
        "''#     ''                           ''~~~~~''''''''~~~~~''                           ''     #''",
        "'##  ## '' ##    ##    ##    ##    ##''~~~~~''''''''~~~~~''##    ##    ##    ##    ## '' ##  ##'",
        "''#     '' ##    ##    ##    ##    ##''''''''''''''''''''''##          ##    ##    ## ''     #''",
        "''#     ''                           ''''''''''''''''''''''                           ''     #''",
        "'##  ## ''                           ''''''''''''''''''''''                           '' ##  ##'",
        "''#     ''                           ''''''''''''''''''''''                           ''     #''",
        "''#     ''                           ''''''''''''''''''''''                           ''     #''",
        "'##  ## '' ##    ##    ##            ''''''''''''''''''''''            ##    ##    ## '' ##  ##'",
        "''#     '' ##    ##    ##            ''''''''''''''''''''''            ##    ##    ## ''     #''",
        "''#     ''                           ''''''''''''''''''''''                           ''     #''",
        "'##  ## ''                           ''''''''''''''''''''''                           '' ##  ##'",
        "''#     ''                           ''''''''''''''''''''''  E                        ''     #''",
        "''#     ''                       Eeee''''''''''''''''''''''eee                        ''     #''",
        "'##  ## '' ##    ##    ##         eee''''''''''''''''''''''eee         ##    ##    ## '' ##  ##'",
        "''#     '' ##    ##    ##         eee''''''''''''''''''''''eee         ##    ##    ## ''     #''",
        "''#     ''''''''''''''''''''''''''''''''''''''''''''''''''''''''''''''''''''''''''''''''     #''",
        "'##  ## '''''''''''''''''''''''''''''''''''''''''''''''''''''''''''''''''''''''''''''''' ##  ##'",
        "''#     ''~~~~~~~~~~~~~~''''''''''''''''''''''''''''''''''''''''''''''''~~~~~~~~~~~~~~''     #''",
        "''#     ''~~~~~~~~~~~~~~''''''''''''''''''''''''''''''''''''''''''''''''~~~~~~~~~~~~~~''     #''",
        "'##  ## ''~~T~~T~~T~~T~~''''''''''''''''''''''''''''''''''''''''''''''''~~T~~T~~T~~T~~'' ##  ##'",
        "''#     ''~~~~~~~~~~~~~~''''''''''''''''''''''''''''''''''''''''''''''''~~~~~~~~~~~~~~''     #''",
        "''#     ''~~~~~~~~~~~~~~''''''''''''''''''''''''''''''''''''''''''''''''~~~~~~~~~~~~~~''     #''",
        "'##     ''''''''''''''''''''''''''''''''''''''''''''''''''''''''''''''''''''''''''''''''     ##'",
        "''M'''''''''''''''''''''''''''''''''''''''''',,,,,,''''''''''''''''''''''''''''''''''''''''''M''",
        "''M'''''''''''''''''''''''''''''''''''''''''',,,,,,''''''''''''''''''''''''''''''''''''''''''M''",
        "''M'''''''''''''''''''''''''''''''''''''''''',,,,,,''''''''''''''''''''''''''''''''''''''''''M''",
        "''M'''''''''''''''''''''''''''''''''''''''''',,,,,,''''''''''''''''''''''''''''''''''''''''''M''",
        "''M'''''''''''''''''''''''''''''''''''''''''',,,,,,''''''''''''''''''''''''''''''''''''''''''M''",
        "''M'''''''''''''''''''''''''''''''''''''''''',,,,,,''''''''''''''''''''''''''''''''''''''''''M''",
        "'##     ''''''''''''''''''''''''''''''''''''''''''''''''''''''''''''''''''''''''''''''''     ##'",
        "''#     ''~~~~~~~~~~~~~~''''''''''''''''''''''''''''''''''''''''''''''''~~~~~~~~~~~~~~''     #''",
        "''#     ''~~~~~~~~~~~~~~''''''''''''''''''''''''''''''''''''''''''''''''~~~~~~~~~~~~~~''     #''",
        "'##  ## ''~~T~~T~~T~~T~~''''''''''''''''''''''''''''''''''''''''''''''''~~T~~T~~T~~T~~'' ##  ##'",
        "''#     ''~~~~~~~~~~~~~~''''''''''''''''''''''''''''''''''''''''''''''''~~~~~~~~~~~~~~''     #''",
        "''#     ''~~~~~~~~~~~~~~''''''''''''''''''''''''''''''''''''''''''''''''~~~~~~~~~~~~~~''     #''",
        "'##  ## '''''''''''''''''''''''''''''''''''''''''''''''''''''''''''''''''''''''''''''''' ##  ##'",
        "''#     ''''''''''''''''''''''''''''''''''''''''''''''''''''''''''''''''''''''''''''''''     #''",
        "''#     '' ##    ##    ##         eee''''''''''''''''''''''eee         ##    ##    ## ''     #''",
        "'##  ## '' ##    ##    ##         eee''''''''''''''''''''''eee         ##    ##    ## '' ##  ##'",
        "''#     ''                        eee''''''''''''''''''''''eeeE                       ''     #''",
        "''#     ''                        E  ''''''''''''''''''''''                           ''     #''",
        "'##  ## ''                           ''''''''''''''''''''''                           '' ##  ##'",
        "''#     ''                           ''''''''''''''''''''''                           ''     #''",
        "''#     '' ##    ##    ##            ''''''''''''''''''''''            ##    ##    ## ''     #''",
        "'##  ## '' ##    ##    ##            ''''''''''''''''''''''            ##    ##    ## '' ##  ##'",
        "''#     ''                           ''''''''''''''''''''''                           ''     #''",
        "''#     ''                           ''''''''''''''''''''''                           ''     #''",
        "'##  ## ''                           ''''''''''''''''''''''                           '' ##  ##'",
        "''#     ''                           ''''''''''''''''''''''                           ''     #''",
        "''#     '' ##    ##    ##    ##    ##''''''''''''''''''''''##          ##    ##    ## ''     #''",
        "'##  ## '' ##    ##    ##    ##    ##''~~~~~''''''''~~~~~''##    ##    ##    ##    ## '' ##  ##'",
        "''#     ''                           ''~~~~~''''''''~~~~~''                           ''     #''",
        "''#     ''                           ''~~T~~''''''''~~T~~''                           ''     #''",
        "'##  ## ''                           ''~~~~~''''''''~~~~~''                           '' ##  ##'",
        "''#     ''                           ''~~~~~''''''''~~~~~''                           ''     #''",
        "''#     '' ##    ##    ##    ##    ##''~~T~~''''''''~~T~~''##    ##    ##    ##    ## ''     #''",
        "'##  ## '' ##    ##    ##    ##    ##''~~~~~''''''''~~~~~''##    ##    ##    ##    ## '' ##  ##'",
        "''#     ''                           ''~~~~~''''''''~~~~~''                           ''     #''",
        "''#     ''                           ''~~T~~''''''''~~T~~''                           ''     #''",
        "'##  ## ''                           ''~~~~~''''''''~~~~~''                           '' ##  ##'",
        "''#     ''                           ''~~~~~''''''''~~~~~''                           ''     #''",
        "''#     '' ##    ##    ##    ##    ##''~~T~~''''''''~~T~~''##    ##    ##    ##    ## ''     #''",
        "'##  ## '' ##    ##    ##    ##    ##''~~~~~''''''''~~~~~''##    ##    ##    ##    ## '' ##  ##'",
        "''#     ''                           ''~~~~~''''''''~~~~~''                           ''     #''",
        "''#'''''''''''''''''''''''''''''''''''''''''''''''''''''''''''''''''''''''''''''''''''''     #''",
        "'##'''''''''''''''''''''''''''''''''''''''''''''''''''''''''''''''''''''''''''''''''''''     ##'",
        "''#''                                ''''''''''''''''''''''                           ''     #''",
        "''#''      #  #  #  #  #  #  #  #  #  #  #   ''''''   #  #  #  #  #  #  #  #  #  #  # ''     #''",
        "'##MM#     #  #  #  #  #  #  #  #  #  #  #   ''''''   #  #  #  #  #  #  #  #  #  #  # ''  #####'",
        "''#  #                                       ''''''                                   ''''M  #''",
        "''#<<#                                       ''''''                                   ''''M<<#''",
        "'############################################MMMMMM############################################'",
        "''#''#''#''#''#''#''#''#''#''#''#''#''#''#''#''''''#''#''#''#''#''#''#''#''#''#''#''#''#''#''#''",
        "''''''''''''''''''''''''''''''''''''''''''''''''''''''''''''''''''''''''''''''''''''''''''''''''"
      ],
      "palettes": [ "arcology_palette" ]
    }
  }  
]
